1111111111111111111111111111
1E0010C000000000000000000001
1000111000000000000000000001
1P0000000011110000000000M001
1000000000000100000000000001
100C000000001100000000000001
1111111111111111111111111111