11111111111111111111111111111111111111111111111
1E0000C0000000000000011100000C000000000000000C1
11111111111111111111000000111111110000111111111
1P000000000000111011111111000000010000000000001
100011111111111C1000111100000000010000000000001
100C0000000000100000100000000011111111000000001
1000111111110010111110011000000001E1C0000000001
100010C0000110100000100110000000011111111111001
10001001000100100000000110000111111111110001001
10000001000000100000100110000000000000100001001
10111111111110101110100110000000000000000CC1001
10000000010000100000100110000111111100100CC1001
10000001000100100000100110000111111100100111001
10000111111111100000100110000111111111111111001
10000000000010000000100110000000100000000000001
1000000001001000110011C111111110000000000000001
100C0000010010001100111100000011100000100101001
100000000100000000001111000000000000C011C010001
10000011111011100000111101000011100000010010001
1000000C00001111000011C101000001110000000010001
10001111111110000000100001000000000010000010001
100011111111100000001011C10000010011100C0000001
1000111111111000000010111100101100010000000M0C1
100000000000000000001011C0000001000000000000111
1000C0001111111110000C1100000000000C0001000C101
11111111111111111111111111111111111111111111111