1111111111
100010C001
1000111001
1P00001001
1000000001
1000000001
1000000001
1000000001
1E00000001
1111111111
